            #####
     ########   ##
    ##        # ##
   ## $* #*## # ##
  ##  . #  $  $ #          ##
 ##@$* # .  #$################
 # $. # .$ # ..$ $ $ $ $ $ $ #
## . # *$ # * .              #
#   # .  # *  ################
# #$#.  # *  ##
# #  ### *  ##
# #$    .  ##
### $#######
  ##  # #  #
  ##  # ## #
  # $ #    #
  #. .######
  #...#
  #...#
  #####
Author: Tui Leshan + Jordi Domenech
Title: The pistol - a
Comment: added 4 boxes
Date: 2010.5.28
