 ##############
 #      #     ###
##$ *.*.$.*.* $ #
#  $ $ * * $ $  #
# * $ $.$.$ $ * #
# .$ *.*.*.* $. #
# * $.$.$.$.$ * #
# .*.*.* *.*.*. #
##$ $.$ @ $.$ $##
# .*.*.* *.*.*. #
# * $.$.$.$.$ * #
# .$ *.*.*.* $. #
# * $ $.$.$ $ * #
#  $ $ * * $ $  #
# $ *.*.$.*.* $##
###     #      #
  ##############
Author: Alberto Borella + Jordi Domenech
Title: #13 a
Comment: added 12 walls
Date: June 2010
