          #####
   ######## @ #
####          #
#  *****.*****##
#  * $       * #
#  *  ##### $* #
## * ##   ## * #
 # * #     # * #
 # . #     # . #
 # * #     # * #
 # * ##   ## * ##
 # *$ #####  *  #
 # *       $ *  #
 ##*****.*****  #
  #          ####
  #   ########
  #####
Author: Jordi Domenech
Title: Inspired by Nakamiya #3 (b)
Date: March 2010
