###############
###         ###
###.$.$.$.$.###
# . .$.$.$. . #
# $.$.$.$.$.$ #
# .$.$ $ $.$. #
# $.$ ### $.$ #
# .$.$# #$.$. #
# $.$ ### $.$ #
# .$.$ $ $.$. #
# $.$.$.$.$.$ #
# . .$.$.$. . #
###.$.$.$.$.###
###    @    ###
###############
Author: Jordi Domenech
Title: Mini Sasquatch XI #48 (b)
Date: 2011.3.2
