###############
###         ###
###.$.$.$.$.###
# . .$.$.$. . #
# $.$.$.$.$.$ #
# .$.$ $ $.$. #
# $.$ # # $.$ #
# .$.$ + $.$. #
# $.$ # # $.$ #
# .$.$ $ $.$. #
# $.$.$.$.$.$ #
# . .$.$.$. . #
###.$.$*$.$.###
###         ###
###############
Author: Jordi Domenech
Title: Mini Sasquatch XI #48 (a)
Date: 2011.3.2
