 ##############
 #   #        #
 #$$ #.  $$# $#
 #   #.#   #  ##
 #$$ #.# $$# $.#
 #   #.#   #  .#
 #$$ #.# $$# $##
 #.  #.#      #
 #.###.#   $$$#
##.# #.# #    #
# .###.# # $$$#
#......  # @  #
##  ###  ######
 #### ####
Author: Timwi + Jordi Domenech
Title: Timwi's Levels #2 b
Comment: added a box
Date: 2011.3.31
