          #####
  ######### @ #
### $ $ $ $$$ ##
#  .........*. #
# $* $ $ $ # .$#
# $.# ####  $. #
##$.  #  ### .$#
 # .$##    #$. #
 #$. #     # .$#
 # .$#    ##$. #
 #$. ###  #  .$##
 # .$  #### #.$ #
 #$. # $ $ $ *$ #
 # .*.........  #
 ## $$$ $ $ $ ###
  #   #########
  #####
Author: Jordi Domenech
Title: Inspired by Nakamiya #3 (a)
Date: March 2010
