############
#....#     ######
#....# $ $  $ $ #
#... #$#### $   #
#...   @ ##   $ #
#..  # #  $ $   #
###### ##$ $ #$ #
  # $  $ $ $ #  #
  #    #     ####
  ############
Author: Thinking Rabbit + Eric F. Tchong
Title: Level 2
