 #### #############
##@ ###       #   #
# $$   $$ $$ $ ...#
#  $$$#    $  #...#
# $   # $$ $$ ##..#
###   #  $    #.*.#
#.  ### $ $ $ #...#
#. . ###### ## .#.#
##.#  #  $ $ # ...#
#.$ # # $$ $  ## .#
# ..# #  $      #.#
# ..# # $$$ $$$ #.#
##### #       # #.#
    # ######### #.#
    #           #.#
    ###############
Author: Thinking Rabbit + Jordi Domenech
Title: Level 10
