#####
#   ######
#        #
## #.#$# #
 # #.#   #
 # #.$$###
 # #.# $ #
## #...  #
# $# #####
#  #  #
#  $$ #
####@ #
   ####
Author: Jordi Domenech
Title: Level 90 Big L
