           ####
    ######## .#
    #      .$ #
    #  .####  #
######$##. # .#
#    #     $ ##
#  # . $ .#   #
#  #$######$# #
## #  . # $   #
#. $  #$# #  ##
#  .#  .# ##$#
######       #
    #  ####@ #
    # $#  ####
    #  #
    ####
Author: Jordi Domenech
Title: Level 69 Mini-maze
