####
#  #####
#      ####
# $ $  #  #####
##### ##    $ #
 #  #  $  #   #
 #     ##$#####
 # $##  # ...#
 ## ##$ ##.#.#
 #   #   #...#####
 # $ #$ $#...#   #
 ### #   #...    #
  #  # $ $ $ ## ##
  # $## #######  #
  #       @      #
  #############  #
              ####
Author: David W. Skinner + Jordi Domenech
Title: Sasquatch #42 c
Comment: arrange map
Date: 2015.10.6
