   ####     ####
####  #######  ####
# ...  . #. .  .  #
# *$$ .$. * * .$. #
# *.. * * *.$ * * #
# $$* * * *$. * * #
# ..*#$.$#* *#$.$ #
##$$$  $  $ $  $ ##
# .. # . #. $#. . #
# *$. .$. *.  * * #
# *.$ *.* *$. * * #
# *$. *@* * $.* $ #
# *.$ * * *  $* . #
# $$  $ $ $   $ $ #
###  #  ###  #  ###
  ####### #######
Author: John C. Davis + Jordi Domenech
Title: Level 70 Sokoban!
Comment: Level 2+
