####
#  ############
#  $ $ $ $ $  #
#@ . . . . .  #
############ ##
#  $ $ $ $ $  #
#  . . . . .  #
## ############
#  $ $ $ $ $  #
#  . . . . .  #
###############
Author: Jordi Domenech
Title: Level 105 Sokoban pilgrimage
