#####      ####
#   ########  #
#           * #
## #########  #
 # #       # ##
 # # ##### # #
 # # #   # # ####
 #@# # # .$.$.  #
 # # #   $.$.$  #
 # # ##### # ####
## #       # #
#  ######### ##
#           * #
#  ########   #
####      #####
Author: Thomas Reinke + Jordi Domenech
Title: Level 67
Comment: Patera #1+
