#####         #####
#   ###########   #
# *     #   #   # #
#.*.  #   #   #   #
##.#$########### ##
 # # #   #   $   #
 # # # .$.$. # # #
 # # # $ * $ # # #
 #$# ##.*@*.## #$#
 # # # $ * $ # # #
 # # # .$.$. # # #
 #   $   #   # # #
## ###########$#.##
#   #   #   #  .*.#
# #   #   #     * #
#   ###########   #
#####         #####
Author: unknown + zhenying + Jordi Domenech
Title: Level 65
