#######################
#           #   #     #
# * * *** * # . # *$* #
# * * *   * # * # * * #
# * * *   * # * # * * #
##**.#**#$* # * # * *##
# * * *   * # * # * * #
# * * *   * # *   *@* #
# * * *** *** *** *** #
#     #   #           #
#######################
Author: Eric F. Tchong + Jordi Domenech
Title: Level 75
Comment: based on Dushi 4 #36 Hellu
