        ######
        # .  #
        # *$ #
 ######## .$ #
 #      # .$#########
## $$$$$$*.*        #
# .*.*.*..@..*.*.*. #
#        *.*$$$$$$ ##
#########$. #      #
       # $. ########
       # $* #
       #  . #
       ######
Author: Jordi Domenech
Title: Level 98 Windmill
