###################
#......    $......#
#. #$##$##$##$# $.#
#.$   $        $ .#
#.$# ###$###$# ##.#
#.   $     $    $.#
# #$###$# ##$# ##$#
#  $    $@   $    #
#$## #$## #$####$ #
#.$       $     $.#
#.$# ###$###$# ##.#
#.       $     $ .#
#.$##$#$#####$ #$.#
#...... $   ......#
###################
Author: Jordi Domenech
Title: Level 77 Rayas
