                 ####
 #################  #
 #                . #
 # ###############  #
 # #             # ##
 # # ########### # #
## # #    #    # # #
#    $ ##$# ##$# # #
#  ### #  #  # # # #
## #   $ ... # # # #
 # # #$##.#.## # # #
 # # # # ... # $ # #
 # # # #  #    ### ##
 # # # ## #$#  . $  #
 # # #    #   ##$#  #
 # # ###########   ##
 # #             # #
##$############### #
# *       @        #
#   ################
#####
Author: Jordi Domenech
Title: Marrakesh souk
