          ####
###########  #
#      $     #
#  *######## #
## *       # #
 # # ##### # #
 # # #   # # #
 # # # @ # # #
 # # # $ * # #
 # # ##.## # #
 # *       * ##
 # *********  #
 #     .      #
 #  ###########
 ####
Author: Jordi Domenech
Title: rings 2
