         ####
##########  #
#           #
#  # *** ## #
## # *  . # #
 # # *  * # #
 # ##***  # #
 # # * # ## ##
## # .     * #
#  #$.####   #
# $$ @#  #####
#  ####
####
Author: Jordi Domenech
Title: Broken P+
