 ####
 #  #########
 #    $     #
 # #### ##  #
 # # . $ # ##
 #  $*.*.# #
 #$# .@. #$#
 # #.*.*$  #
## # $ . # #
#  ##$#### #
#          #
#  ##  #####
########
Author: Jordi Domenech
Title: karakuri box
