 ##########
 #   ##   #
 #  $     #####
### ####...#  #
# $   # ...   #
#   $ # ...#  #
## ######### ##
## ##  #   #  #
# $  $ # $  $ #
#   #  ## ##  #
##### ###  ####
   # $   $ #
   #  @##  #
   #########
Author: Jordi Domenech
Title: 1000 rooms
