            ####
        #####  #
        #      #
 ####   #  ##  #
 #  ###### # .###
 #    . .# #$ $ #
 # ## #$ $ # .# #
 # # .# .# #$ # #
 # #$ #$ # # .# #
 # # .# .# #$ # ##
 # #$ #$ # # .#  #
 # # .# .# #$ # $#
 # #$ #$ # # .#  #
 # # .# .# #$ # $#
## #$ ## # # .#  #
#  # . $ # #$### ##
#   $ #$.+ .  .   #
####  #  ######   #
   #######    #####
Author: Jordi Domenech
Title: pipe organ
