#########   #####
#   #   #####   #
# $   $       $ #
##$######$# ##$##
 # #...... . #  #
##    .. # $ .  #
#  ## ########$##
#  $  #       $ #
####  @ #####   #
   ######   #####
Author: Jordi Domenech
Title: classic rows
