         #########
##########   #   #
#    #   #       #
#        ...## ###
### ## #.. ..#   #
#   #  ..###..   #
#     #.......# ##
## ####.# ###.#  #
#     #.     .   #
#   #  .   # .#  #
### ##############
# $ $ $ $ $ $ $  #
#  $ $ $ $ $ $ $ #
##$ $ $ $ $ $ $  #
 # $ $ $         #
 #  @    #########
 #########
Author: Jordi Domenech
Title: A
