#############
#     #     #
# ********* #
# *       * #
# * ##### * #
# * # + #$. #
# * # * # * #
# $ # * # * #
#   # * # * #
### # * # * #
 #  # *   * ##
 #    *****  #
 #  #   #    #
 #############
Author: Jordi Domenech
Title: snail 2
