# ######
 ##    #
##  $ $#
# .$.$.#
# $.$.$#
# .$.$.#
# $.$.$#
# .$.$.########
# $.$. .$.$.$ #
# .$.$.$.$.$  #
#  .$.$.$.$.$ #
####.$.$.$.$  #
   # .$.$.$. ##
 # #       @##
#  ########## #
Author: Jordi Domenech
Title: ornate capital L
