###########   ###########
#  #  #   #####   #  #  #
# **  ***   *    ** *** #
# * * *    * *  *   *   #
# **  ** #* * *#*  #*.# #
# *   *   *   * *   *   #
# *$  *** * # *  ** *** #
#@ #  #   #####   #  #  #
###########   ###########
Author: Jordi Domenech
Title: peace
