#####    ####
#   ######  #
# *      $* #
##$## ####  #
# $    $ # ##
# $$##...# ##
# #   ...#  #
#   # #$  . #
##### @ ##  #
    #########
Author: Jordi Domenech
Title: six
