##########
#   #    #
# .$.$$. #
## #   $ #
##.####.##
# $   # ##
# .$$.$. #
#    # @ #
##########
Author: Jordi Domenech
Title: Level 46
