 ####  ####
 #  ####  #
 #$ $ $   #
 # ....#  #
## ## ## ##
#  #.... #
# $ $ $$$#
#  ####@ #
####  ####
Author: Jordi Domenech
Title: Level 58
