###########
#   ##    #
# $  $ $$ #
# $#*#.#  #
#  ....* ##
##$#.@.#$##
## *....  #
#  #.#*#$ #
# $$ $  $ #
#    ##   #
###########
Author: Jordi Domenech
Title: Level 54
