###############
#   #    #    #
# $...*.$# $$ #
# $.# $.   $  #
###.###*####$##
#  * # . # $  #
# $*....$   $ #
#    ##  # @  #
###############
Author: Jordi Domenech
Title: Level 50
