  #####
  #   #####
  # #$#   #####
  #   . #$#   #
 ### ##     # #
 # $ # # ## $ #
 #    . . #.###
 ## ##@# ## ##
###.# . .    #
# $ ## # # $ #
# #     ## ###
#   #$# .   #
#####   #$# #
    #####   #
        #####
Author: Jordi Domenech
Title: Level 60
