  #####
###   ######
#   $    $ #
# ##*##*## ##
# ## ## ##  #
# * . @. *$ #
# ## ## ##  #
# ##.##*## ##
#          #
######   ###
     #####
Author: Jordi Domenech
Title: Level 51
