###########
#        ##
# $ $ $ $ #
# ######  #
#  ....#$ #
##*  $.#  #
# * # .#$ #
# *   .   #
# ****.#$ #
#  @ #    #
###########
Author: Jordi Domenech
Title: Level 47
