#########
#   #   ##
#   $.#  #
##$#+$.$ ##
 # .$#$.  #
 ##$.$. . #
  #  .$## #
  ###     #
    #######
Author: Kevin Cassol
Title: Level 93
