##### #####
#   ###   #
# #  .  # #
# .$.*.$. #
## ##.## ##
#  ##$##  #
# $ $+$ $ #
#    #    #
###########
Author: Jordi Domenech
Title: Level 90
