      ####
   ####  #
 ### $   #
##   # # #
# $#.@. $#
#   .*.  ##
##$#.#.#$ #
 #   $    #
 #  #######
 ####
Author: Kevin Cassol
Title: Level 49
