    ##########
#####... ....#
#     # $  $ ####
# #######$####@ ###
# #    ## #  #$ . #
# # $$ ...#* #  #.#
# # $  #   . #$ . #
# #  ### ##. $  #.#
# ###  #  #  #$ . #
# #   $# $####  #.#
# #$   $  $  #$ . #
#    $ # $ $ #  #.#
#### $###    #$ . #
 # $  $ $$ ###....#
 #        ## ######
 #   ######
 #####
Author: Thinking Rabbit + Jordi Domenech
Title: Level 80 Original remixed #20 arr.
