    ######
    #    #
#####$## #
#   #    #
# $ ...# #
## #...# #
 # ##### #
 # # #   #
 # ### # ##
 # $ $ $$ #
 #   # @  #
 ##########
Author: Jordi Domenech
Title: Level 28
