##########
#   ##   #
#   .    #
##$#.###$#
#   .### #
# ##.$ # #
#  $...$ ##
##$## ##  #
# $       #
#  @#######
#####
Author: Jordi Domenech
Title: Level 20 Big L
