 ############
##          ##
# $**.*.**$  #
#.*  *#*  *$ #
# $**.*.**$ @#
#           ##
#############
Author: Jordi Domenech
Title: Level 25
