     #####
 #####   #####
 # .   #.    #
 # #.#$#.##  #
##$#.$    $$##
# $  ## #$# ##
#.#$ .  .  $ #
# # ####$#.# #
# $ ..  $. # #
#   ## @ #   #
##############
Author: Jordi Domenech
Title: Level 11 Slalom
