#############
#           #
# #### #### #
# #       # #
# # ***** # #
# # *   * # #
# . *$+$* . #
# # *   * # #
# # ***** # #
# #       # #
# ####$#### #
#           #
#############
Author: Jordi Domenech
Title: Level 1
