#################################
#   #   #   #   #   #   #   #   #
# #.$.# # #$ $# # # #$# #.#$  # #
# #   # # #   # # #.$.# #.#   # #
# #*.*#   #$.$#    .*.   .#.$## #
# # $ # # # $ # # #.$.# # # $ # #
# $.@.$ # ..... # $   $ # $. .$ #
# ##$## # ##$#######$## # ##$## #
#       #       #       #       #
#################################
Author: Jordi Domenech
Title: Level 2 Zen
