###############
#   $ ..#  .. #
# ##  ##   #$$#
# .##  $$$$  .#
## $ $ $  $ #.#
#..# .#$@ $ $ #
# $##  $$$$   #
#   .  #   #.##
#.#$##.. $##$ #
# .  # ## ..  #
#  #..$ .  .#.#
###############
Author: Jordi Domenech
Title: Level 9 Small maze
