 #########
 #  ##   #
 #    $  ###
 # $###$#  #
###.*.$ #  #
#  ...#    #
# $...  # ##
## ###$##$ #
#    $     #
#  ### @####
#  # ####
####
Author: Jordi Domenech
Title: Level 12
