###############
#      #  #   #
#.**** # ## * #
#    * #  #   #
#### * ########
#  # * #      #
# ## * # **$  #
## # * # *  @##
# ## * # * ####
## # *   * #  #
# ## ***** ## #
#  #       #  #
###############
Author: Jordi Domenech
Title: Level 28 Small snake
