    ######
 ####    #  ####
 #  #$#$ ####  #
##    $   $    #
#  #### #####  #
# $#...* #  # ##
#  #..*.. ..# #
## # #####$##$##
# $          $ #
#   #### @ #   #
#####  #########
Author: Jordi Domenech
Title: Level 13 Original #29 revised
