#########
#   ##  #
# $     #
##$#$## ##
 # . . . #
 #$.#.$.$#
 # * * * #
 #$.$.#.$#
 # . . . #
 ## ##$#$##
  #     $ #
  #  ## @ #
  #########
Author: Jordi Domenech
Title: Level 18
