    #######
    # .   #
#####.+. $###
#   ##.#    ###
#   $  #*#    ##
# #$#$##  *#   #
#   $ ####  *# #
#   # #  ###   #
##### #   #  *##
   ## ##### #  #
   #      #  * #
   # **## ##   #
   ###   *  *###
    #  #  ## #
    #    ##  #
    ####    ##
       ######
Author: Alberto Garcia + Jordi Domenech
Title: Level 67
Comment: Bonus #12
