 ####       #####
 #  #########   #
 #            $ #
## ########### ##
#  #  #      # #
#  .* #    # # #
#  #  ### $ $# #
#### #### ## # ##
  ## #  $ # $ $ #
 ##  # $#$#  #  #
 #.. .. @ ##    #
 #..$############
 #.. #
 #####
Author: Alberto Garcia + Jordi Domenech
Title: Level 82
Comment: Alberto #26
