  #########
  #       #   #####
  # ##### #####   #
### #  #       .# #
#   # $#$## # # # #
# ###     #   # @ #
#  ##$ ## *  ## ###
##     #####*#.. #
## #$####  # #.. #
#  #  $    #  .. #
# $$  # ## #  ####
#  ## # #  ##   #
#####   #    *# #
    #########   #
            #####
Author: Alberto Garcia + Jordi Domenech
Title: Level 72
Comment: Fantasy #34
