  ###############
### . $  .  $   ###
#   #   ###   #   #
# ####$## ##$#### #
# #  # #   # #  # #
# #  # #   # #  #.#
# #### ## ## #### #
#  # $. ### . ##  #
#  $ .$. @ .$. $  #
#  ## . ### .$ #  #
# #### ## ## #### #
#.#  # #   # #  # #
# #  # #   # #  # #
# ####$## ##$#### #
#   #   ###   #   #
###   $  .  $ . ###
  ###############
Author: Alberto Garcia + Jordi Domenech
Title: Level 38
Comment: Birthday #96
