    ###############
  ###   #     *   #
###   # * ## # ## #
#   ####    *#  # #
# ###   *### #  # #
#  #   # ### ##   #
##   #*  $ #  ### #
#  #   ###    ##  #
# ### ###+### #  ##
#* # *  #   # # ##
#       # #  *  ##
# #  # *  #####* #
# #*#####  ###   ##
# # *   ##*    #  #
#    #  *   # *   #
####   ####   #####
   #####  #####
Author: Alberto Garcia + Jordi Domenech
Title: Level 78
Comment: Fantasy #50
