    #####
   ## . ####
  ##  .    #####
 ##  $.# #$    ###
 #   ###    # @  #
 # $ # #  ###$#  #
##$######### ...##
#  ##   #    #  #
#       #  # # ##
##### #### # # #
    # ##   # # #
   ##$##...# # #
   # $    ## # #
   # #### ##$# #
   #      # $  #
   ########    #
          ######
Author: Alberto Garcia + Jordi Domenech
Title: Level 54
Comment: Bonus #21
