###################
#        *        #
# #######$####### #
#   #     #   #   #
# # # # #$# # # # #
# # # # # # # # # #
# # # # # # # # # #
# # # # #.# # # # #
# # # # .+.   # # #
# # # #$#.### # # #
# # #   # #   # # #
# # ###$# # ### # #
# #   # # # #   # #
# ###   # #   ### #
# #######$####### #
#                 #
###################
Author: Alberto Garcia + Jordi Domenech
Title: Level 39
Comment: Bonus #13
