 ###########
 #     ##  #
 #   $   $ #
#### ## $$ #
#   $ #    #
# $$$ # ####
#   # # $ ##
#  #  #  $ #
# $# $#    #
#   ..# ####
####.. $ #@#
#.....# $# #
##....#  $ #
 ##..##    #
  ##########
Author: Thinking Rabbit
Title: Level 33
