        #######
    #####  #  ####
    #   #   $    #
 #### #$$ ## ##  #
##      # #  ## ###
#  ### $#$  $  $  #
#...    # ##  #   #
#...#    @ # ### ##
#...#  ###  $  $  #
######## ##   #   #
          #########
Author: Thinking Rabbit
Title: Level 43
