##########
#        #   #####
# $ $$#  #   #.  #
# ##  #$ #####.# #
#  ##.*  .    .$ #
# $#  # $##### ###
#  $ $#. #   # #
# ##  $$##   #$#
#     #  #   # #
###.#### ##### #
  # #  #  @  # #
  # #  #####.#.####
  # #      #      #
  # #      # #.## #
### ######## # $  #
# ...  $   .   #  #
# # ########.###$ #
#   #      #      #
#####      ########
Author: David Buchweitz + Jordi Domenech
Title: Chrysalis Collection 1 #25 Skytracks
Comment: added 8 boxes
