################
##     #   #   #
#  ##.$  $   $ #
#  .  ## #.##.##
# ## $ # #$##  #
#.##$# .  $    #
#      ##.#  # #
##$###.$+ ##.# #
#   #   #$$. # #
#.# $ #    # $ #
# $$### ##.# #.#
#     .$## $ . #
##.##$#  .  ## #
# $  $ .###. # #
#    #         #
################
Author: Jordi Domenech
Title: Level 65 Maze
