#########
# .   . #
#.#$$$#.#
# $ . $ #
#$#.#.#$#
# $ . $ #
#.#$$$#.#
# . @ . #
#########
Author: Jordi Domenech
Title: Level 48
