 #########
##       #
#  $.$.$.#
# $.$.$.$#
# .$*$.$.#
# $.$.$.$#
# .$.$.$.#######
# $.$.$. .$.$. #
# .$.$*$.$.$.$.#
# $.$.$.$.$.$. #
#  $.$.$.$*$.$.#
#  .$.$.$.$.$. #
####.$.$.$.$.$.#
   #  $.$.$.$  #
   #          @#
   #############
Author: Jordi Domenech
Title: Level 40
