   #####
  ##@  ###
 ## .$.  ###
 # .$.$.   ###
##.$.$.$.$.  ###
# $.$.$.$.$.$  ##
#  $.$.$.$.$.$  ##
##   .$.$.$.$.$  #
 ### $.$.$.$.$.$ #
   ##  .$.$.$.   #
    ## $.$.$.$ ###
     ### .$.$ ##
       ### $. #
         #   ##
         #####
Author: Jordi Domenech
Title: Level 37
