 ###########
##         ##
#  $.$.$.$. #
#@$.$.$.$.$.#
# .$#####$. #
# $.#   #.$ #
# .$#   #$. #
# $.#   #.$ #
# .$#####$.$#
# $.$.$.$.$ #
# .$.$.$.$. #
##       . ##
 ###########
Author: Jordi Domenech
Title: Level 24
