#############
#.      $  .#
# .$.$.$.$. #
# $.$.$.$.$ #
#$.$.$ $.$. #
#.$.$ @ $.$.#
# .$.$ $.$. #
# $.$.$.$.$ #
# .$.$.$.$. #
#.  $       #
#############
Author: Jordi Domenech
Title: Level 9
