            ####
         ####  #
         #   * #
 #####   #  #  #
 #   ###### # ##
 # *        # #
 ## ######  # #
 ##   #  #### #
 #  * #       #
 # #$## ### # ##
 # # #  ..# #  #
## # # @ .# *  #
#  # # ####$## #
# *$       * # #
#  ##### #   # #
####  #  ##### #
      # *      #
      #  #######
      ####
Author: Jordi Domenech
Title: Level 13 Pink maze
Set: Life #32
