    #####
 ####   #
 #  # # #
 # ..   #
 # .##$ #
## ..# ###
#  # $   #
# $##$$  #
# $   # ##
#####.@ #
    #####
Author: Kevin Cassol
Title: Level 68
