    #####
   ##   ## #####
  ##  *  ###   ##
 ##  * *  #  *  ##
##  * # *   * *  ##
#  * ### * * # *  ##
# . ## # #*# ## *$@#
#####  #  .  ### $ #
       ####### #   #
               #####
Author: laizhufu + Jordi Domenech
Title: Level 91 M
