   #####
####   #
#    # ##
# $#$*  #
## . .  #
 #$.$*###
 # .$.##
 #$.$. #
 # .$#@#
 #$.   #
 #   ###
 #####
Author: Kevin Cassol
Title: Level 100
