#########################
#  *   *  *.*    *    * #
# . $ * *  $  # *$*  *  #
#@ *   *   *  *  .  *   #
#########################
Author: Jordi Domenech
Title: Level 59 Walking
