    #####
    #   ####
    # # #  #
    # $ # $#
    ##  #  #  ####
     #$ # $#  #  #
#### #  #  #  # $#
#  ###$   $#  #  #
#   ...#   #### $#
# # #@#  #$      #
#.#$$$#     #$$ $#
#.........#   #  #
## ###.#########$#
 #  .*.. #   #   #
 ### #.#   #   #$#
   # $ ######### ##
   # #*           #
   #   ########   #
   #####      #####
Author: David Buchweitz + Jordi Domenech
Title: Chrysalis Collection 5 #23 Toy Pom
