      ####
    ###  #####
    #        ###
   ##$##. ##$  #
 ###.  ##.$ .# ##
 # $ $ #. #  .$ #
##.#   $$.$.  # #
#  ###$#  #$#$# #
#  .# $ *. . .  ##
##  . . .* $ #.  #
 # #$#$#  #$###  #
 # #  .$.$$   #.##
 # $.  # .# $ $ #
 ## #. $.##  .###
  #  $## .##$##
  ###        #
    #####@ ###
        ####
Author: David Buchweitz + Jordi Domenech
Title: Chrysalis Collection 6 #37
