       ###########
      ##  $. . $ ##
   ####  * ### .$ ####
 ###   . $## ## .$.  ###
##   * #$.#   #.$##.$  ##
# $. # #  #   #  ####.$ #
#   ##$#$.#   #.$#  #   #
##$.#       #       #.$##
#   #  #$.#   #.$#$##   #
# $.####  # @ #  # # .$ #
##  $.##$.#   #.$# *   ##
 ###  .$. ## ##$ .   ###
   #### $. ### *  ####
      ## $ . .$  ##
       ###########
Author: Eric F. Tchong + Jordi Domenech
Title: Dushi 9 #1 Return to Sorrento - a
Comment: added 2 boxes, 3 walls
Date: 2014.12.5
