 #############
##  #     #  ##
# * * *$* * * #
#* * * * * * *#
#             #
#.#.#.# #.#.#.#
# $ $ $ $ $ $ #
#######+#######
# $ $ $ $ $ $ #
#.#.#.# #.#.#.#
#             #
#   #  #  #   #
###############
Author: Sven Egevad + Jordi Domenech
Title: SE 1002 b
Comment: added a box
Date: 2012.11.12
