   #####          ####
   #   ############  #
   #                 #
##### ## ########### ##
#     ## #    #    #  #
# *$$ ##$$$#.$$$# $$$ #
# *.* #    #... #.  . #
# * $.# ...#. #.#. #.##
##. $.#.$$* .$$* *$$*#
# *.+ # ...#... # ...##
# $ $## $$$# $$$#  #. #
# $$$ #  # #  # # **$ #
#     ##   #    #  #  #
### ############## ####
  #                #
  ##################
Author: Carlos Montiers + Jordi Domenech
Title: Habibti - a
Comment: major changes
Date: 2012.3.27
