 #################
 #      .        #
 # #####*####### #
 # #    .      # #
 # #   ..*  @  # ##
 # #####*#$####   #
 #  $.......... # #
##$ $ ##.#### # $ #
# $$ ###.     #$$ #
#   $###.####   $ #
###   $  #  #$##$ #
  #  $$$##  #  #  #
  ##    #   #  ####
   ######   #  #
            ####
Author: Bruno Druille + Jordi Domenech
Title: Tableau 81 e
Comment: major changes
Date: 2012.5.5
