   #####
   #   ########
####$  $   @  #
#  # ######## ##
# $$        #  #
#  # ###$## $$ #
# $# #   #..#  #
#  # #$  #..# ##
#  # # $ #. #  #
# $# # $ #  ## #
#      $ #...  #
######  ##..# ##
  #  #  #...#$#
  # $#$ #...# #
  # $   #...# #
  #  ## ##### #
  #   $  $    #
  ##  #####   #
   ####   #####
Author: unknown + Jordi Domenech
Title: Level 71 Old style
Comment: Cb7 phg10 arranged
