  ###########
  #      #  ### ####
  # * $. #    ###  #
  ## ## ##  # $    #
   #  # ###$##$##  #
##### #  ##   $ # ##
#  ##$##..   #$ # #
#  $    ..####  # #
#  # #### $  # ## ##
## #.   #$## #   $ #
# $ ..#    $   # # #
#   # #### # ###   #
#####$$ #  . ..#$###
    # # #$.. ..  #
    #   @ ..######
    #########
Author: Jordi Domenech
Title: Level 100 Homage to Premysl Zika
