 ########
 #   #  #
 #   $  #
#### ## ##
#    # ..#
#  # # ..#
##$$ # # ##
#  ###  $ #
#   ..$$# #
#  ###  @ #
#### ######
Author: Jordi Domenech
Title: Level 31
