####### ##############
# *** ### ***     *  #
#   * ...   . $$$ *  #
#@***$$$$ ***#...$.$ #
# *   ...   . $$$ *  #
# *** ### ***     *  #
####### ##############
Author: laizhufu + Jordi Domenech
Title: Level 75
