#################
#     . . . . . #
#. # $ $ $ $ $  #
# $############ #
#. #     . . #  #
# $#. # $ $  #$ #
#. # $###### # .#
# $#. #   #  #$ #
#. # $ $. #$ # .#
# $#  #   # .#$ #
#. # ######$ # .#
# $#$ $ $ # .#$ #
#  . . .     # .#
# ############$ #
#  $ $ $ $ $ # .#
#@. . . . .     #
#################
Author: Alberto Borella + Jordi Domenech
Title: Level 76
Comment: Level 6 extended
