##############
##     *    ##
#  # ## ## $##
#  * *  ..  ##
## ## ## ##*##
##    *   * ##
##*$##$## # ##
##       *  ##
##*##*## ## ##
##  .     *  #
##.$## ##*#  #
##    *  @  ##
##############
Author: Jordi Domenech
Title: Level 79 Absurd labyrinth
