             ###
         #####  #  ##
      ####      # #..#
   ####    $$## # #..#
 ###    $$## #  # #..#
#    $$## #  # $# #..#
# $$## #  #  #   #  .#
### #  #  #  ## #    #
  # #  #  ####      #
 ## #  ####    #   #
 #  ####     #   ##
 #     # # #    #
 #  #@       ###
  ###########
Author: Ghislain Martin + Jordi Domenech
Title: SokoStation #369 THUMB UP
