#####################
#   #   #   #   #   #
# # # #   # # #   # #
#   #   #   #   #   #
###*###*###*###*###*#
#   #   *   #   *   #
#@#$# # # # # # # #.#
#  *    #   $   #   #
###*###*###*###*###*#
#   #   #   #   #   #
# #   # # #   # # #.#
#   #   #   #   #   #
#####################
Author: Ghislain Martin + Jordi Domenech
Title: SokoStation #368 IDEE PROVISOIRE
