####################
#  * . #  .$  *.  .#
#$ . # * $   * $$$ #
# * $.  $*#. $. #  #
#  .# * # .$ # $.$.#
# $ * .* *  # #$ # #
#* * $  # .* .  . *#
# * # $ .*@ $ #$*# #
#.  . .$  # .$. . .#
# $ *.$ #$.$$ $ $. #
##  $#.$ .*  #.$* ##
#  #  $ #  $.$  .$.#
# $ $..* $#  $$ #. #
#. *   #    .  *  .#
####################
Author: Ghislain Martin + Jordi Domenech
Title: SokoStation #187 OH QUE C'EST BEAU
Comment: added 11 boxes
