    ###############
    #             #
##### ##### ##### #####
#   # #   # #   # #   #
# $  *# . $*# .   # + #
#   # #   # #   # #   #
## ## ## ## ## ## ## ##
 # #   # #   # #   # #
 # # . $*#   $*# . $*#
 # #   # #   # #   # #
 # ##### ##### ##### #
 #                   #
 #####################
Author: Ghislain Martin + Jordi Domenech
Title: SokoStation #376 INSIDE OUTSIDE
