####
#  #####
#...   #
#.##.# #
#.##.  #
#...   #
#.### #####
#.#       #
#  $ $ $$$##
###  #  #  #
  #$$#  #$ #
  #  #  #  #
  #  #  #$ #
  # #####  #
  #  $ $ $ #
  # @      #
  ##########
Author: Jordi Domenech
Title: Level 78 P
