####
#  ####
#...  #
#.# # #
#.#$  #
#..  ##
#.##  ##
#.# .  #
#  $$$ #
###    #
  #$$$##
  #    #
  #$$$ #
  # @  #
  ######
Author: Jordi Domenech
Title: Level 95 F.
