#############
#  # .  #   #
# $$ # $# # #
# .# .  . $ #
#.####.###.##
#  .# $ .   #
#   $ . #$$ #
##.#$##$# . #
#  $ $  #####
# $#.#. $ $ #
#  # .  # @ #
#############
Author: Jordi Domenech
Title: Level 58 Square-maze
